111111
1P00C1
100001
10C001
100001
100E01
111111