1111111111111111111
10000000C0000001111
1001000111000001111
1001000PC0000001111
1001000000000001111
1E001111101100000C1
1111111111111111111