1111111111111111111
1P000000C0000001111
1001000111000001111
10010000C0000001111
1001000000000001111
1E001111101100000C1
1111111111111111111