1111111111111
1P1100C0000C1
1100011110001
10C011E000001
1111111111111