1111111111111
100100C0000C1
1C00011110001
100011PE00001
1111111111111